URULERE SHOWROOM	18 Bode Thomas Street, Surulere, Lagos.
TEJUOSHO SHOWROOM	Oando F/S, Opposite Tejuosho Ultra Modern Market, Yaba
AIRTEL EXPRESS POINT, UNILAG	AC Kiosk Faculty of Education , University Of Lagos, Akoka
ILUPEJU SHOWROOM	22, Town Planning Way, Ilupeju
LAGOON MALL SHOWROOM	Lagoon Shopping Centre, Victoria Island Lagos
SILVERBIRD SHOWROOM	Silverbird Galleria: 133, Ahmadu Bello Way, Victoria Island, Lagos
MATIS MALL SHOWROOM	Matis brass mall 27 castlerock avenue Jakande roundabout, Osapa London, Lekki
AIRTEL EXPRESS POINT, OYINJOLAYEMI OFFICE	1664, Oyinjolayemi street V/I
AIRTEL EXPRESS POINT, KEYSTONE BANK	Keystone Bank - 707 Adeola Hopewell Str. V/I
AIRTEL EXPRESS POINT, HQ	HQ Shop, Banana Island, Ikoyi
ALABA SHOWROOM	36 Alaba International Market Road
AIRTEL EXPRESS POINT, LASU	Airtel Express shop - Faculty of Art, LASU Main Campus, Ojo, Lagos.
APAPA MALL SHOWROOM	Apapa Mall (Shoprite). Park Lane Road, Apapa.
OGBA SHOWROOM	18, Isheri Road, Ogba
OBA AKRAN SHOWROOM	13, Oba Akran Way, Ikeja
IKORODU SHOWROOM	199 Lagos Road, Ikorodu
LAGOS INTL AIRPORT	MMIA Arrival
LAGOS INTL AIRPORT (DEPARTURE)	MMIA Departure
LAGOS DOMESTIC AIRPORT	MMA 2
LAGOS DOMESTIC AIRPORT	Arik Terminal
OPEBI SHOWROOM	Pentagon Plaza, 23 Opebi Road, Ikeja, Lagos
ABUJA SHOWROOM	Sticks and Stone Plaza (Plaza with GTB) Plot 1245 Adetokunbo Ademola Crescent, beside Otis Carpet Plaza, Wuse 2, Abuja.
TRANSCORP HILTON	1st Floor, Transcorp Hilton,  1 Aguiyi Ironsi road, Maitama
AJESA SHOWROOM	No 17 Ajesa street, off Aminu Kano Crescent, Wuse 2
AIRTEL EXPRESS POINT, SILVERBIRD	Silverbird Galleria, Plot 1161, Memorial Drive, By Musa Yar'adua Centre, Central Business District
APO MALL SHOWROOM	Shop 12, Apo Mall (Shoprite Mall), Plot 232, Cadastral Zone B14 Dutse, Abuja
ABUJA INTL AIRPORT	Nnamdi Azikiwe Airport, Domestic Arrival
ABUJA DOMESTIC AIRPORT	Nnamdi Azikiwe Airport - Domestic Departure Lounge;
KADUNA SHOWROOM	4, Yakubu Gowon Way, Kaduna
AIRTEL EXPRESS POINT, KASU	AC Kiosk Kaduna State University,Tarfa Balawa Way, Former ABU Teaching Hospital, Kaduna
AIRTEL EXPRESS POINT, ABU	AC Kiosk Ahmadu Bello University(ABU) Main Campus,Opposite Ribadu Hotel, Zaria, Kaduna
MINNA SHOWROOM	18B Paiko Road, around Tunga market, Minna
MINNA OUTPOST	AC kiosks- FUT minna, Post office area
JOS SHOWROOM	13 Murtala Mohammed Way Jos
SOKOTO SHOWROOM	16 Maiduguri road opposite polaris bank Sokoto
BAUCHI SHOWROOM	22, Commercial Road, Opp FCMB, Bauchi
GOMBE SHOWROOM	Beside Accountant General  Office, Opp Bauchi Park, Along Bauchi-Gombe Road, Gombe
MAIDUGURI SHOWROOM	26, Sir Kashim Ibrahim Way, Maiduguri
MAIDUGURI OUTPOST	AC kiosk, University of Maiduguri, opposite ICT centre.
PRIME HUB MALL	Prime Hub Plaza, No 7 Zoo Road, Kano
KANO SHOWROOM	Kano Regional Office: 2 Yolawa street, opp. Mallam Kato square, Kano
MAKURDI SHOWROOM	Plot 1332, Ogiri Okoh Road, Old GRA, Markudi
ENUGU SHOWROOM	Plot 6, Ebeano Est. Independence Layout, Enugu
POLO PARK MALL SHOWROOM	Shop 26, Polo Park Mall, Opposite IMT Campus, Enugu
OWERRI SHOWROOM	96,Whetheral Road, opp Dan Ayiam Stadium, Owerri - Imo State
AWKA SHOWROOM	49, Zik Avenue, Awka
ONITSHA SHOWROOM	4 Awka Road, opposite All Saints Cathedral, Onitsha
ABA SHOWROOM	154B, Okigwe Road, Aba
ASABA SHOWROOM	360, Nnebisi Road, Asaba
DELTA MALL SHOWROOM	Shop 63, Delta Mall, Warri
WARRI SHOWROOM	74, Effurun-Sapele Rd, Beside UBA, Near Water Resources, Warri.
BENIN SHOWROOM	162, New Lagos Road, Uselu, Benin City
EKET SHOWROOM	88, Eket-Oron Road, Eket
UYO SHOWROOM	82, Ikot Ekpene Road, Uyo
CALABAR SHOWROOM	86,Etagbor Road, Calabar
PORT HARCOURT SHOWROOM	12 Evo road GRA Port Harcourt
PH INTL AIRPORT	Departure Lounge, PH International Airport, Port Harcourt.
PH MALL SHOWROOM	Shop 9, PHC Mall, Azikiwe Road old GRA Port Harcourt
YENAGOA SHOWROOM	513 Melford Okilo Road, Bay Bridge Junction, Yenagoa
Ado Ekiti Showroom	12, Ajilosun Street Along Ikere Road Ado-Ekiti
Akure Mall Showroom	Akure Mall, Old Owena Motel, Igbakoro Road, Akure.
Airtel Express Point, Akungba	AC Kiosks, Adekunle Ajasin University, Akungba. Ondo State
Airtel Express Point, Alagbaka	NO 29, OBA ADESIDA RD, AKURE, ONDO STATE
Osogbo Showroom	Moye House, Gbogan-Ibadan Road, Osogbo
Ile Ife Showroom	39, Ibadan Road, Mayfair, Ile-Ife
Airtel Express Point, Oau	AC Kiosk Obafemi Awolowo University, Main market. Ile-Ife
Airtel Express Point Oou - Olabisi Onabanjo University - Ago Iwoye	OOU - Ago Iwoye Market
Ilorin Showroom	185 Harmony complex Ibrahim Taiwo Rd Ilorin
Airtel Express Point, University Of Ilorin	AC Kiosk University of Ilorin Campus, Ilorin
Airtel Express Point, Kwasu	West End Opposite girls hostel, Kwara State Polytechnic, Ilorin.
Airtel Express Point, Oduwoye F/S	AC Kiosk Oduwoye Filling Station, opposite Offa polytechnic, Offa
Ibadan Mall Showroom	UL 64, Palms Shopping Mall, Opp High Court, Ring Road Ibadan
Heritage Mall Showroom	Shop C32, Cocoa House, Dugbe, Ibadan
Agodi Showroom	4, Secretariat Dual Carriage Way, Bodija Ibadan
Abeokuta Showroom	Opposite St Annes Church, Omida, Ibara Abeokuta
Sango Ota Showroom	41, Idiroko Road, Sango Ota
